TILEMAP
30 28							-- Size of tile map in tiles
16 32 							-- Tile size & block size
images/blocks.png 	-- Tilesheet
2 2 								-- Number of tiles in tilesheet
111111111111111111111111111111
1            66              1
1            66              1
1                            1
1       55555555555555       1
1     555555555555555555     1
1   5555555555555555555555   1
1   5555555555555555555555   1
1     555555555555555555     1
1       55555555555555       1
1                            1
1                            1
1                            1
1                            1
1                            1
1                            1
1                            1
1                            1
1                            1
1                            1
1                            1
1                            1
1                            1
1                            1
1                            1
1                            1
1                            1
11111111            1111111111