TILEMAP
30 90 							-- Size of tile map in tiles
16 16 							-- Tile size & block size
images/bloques.png 	-- Tilesheet
2 2 
3								-- Number of tiles in tilesheet
222222222222222222222222222222
2                            2
2                            2
2                            2
2                            2
2                            2
2                            2
2                            2
2                            2
2                            2
2                            2
2                            2
2                            2
2                            2
2                            2
2                            2
2                            2
2                            2
2                            2
2                            2
2                            2
2                            2
2                            2
2                            2
2                            2
2                            2
2                            2
2                            2
2                            2
22         22222222         22
22ddddddddd22222222ddddddddd22
2                            2
2                            2
2                            2
2                            2
2                            2
2                            2
2                            2
2                            2
2                            2
2                            2
2                            2
2                            2
2                          cc2
2                          cc2
2                            2
2                            2
2                            2
2                            2
2                            2
2                            2
2                            2
2                            2
2                            2
2                            2
2                            2
2                            2
2                            2
2                            2
22222                     2222
22222ddddddddddddddddddddd2222
2                            2
2                            2
2                            2
2       eeeeeeeeeeeeee       2
2     aaaaaaaaaaaaaaaaaa     2
2   aaaaaaaaaaaaaaaaaaaaaa   2
2   aaaaaaaaaaaaaaaaaaaaaa   2
2     ffffffffffffffffff     2
2       eeeeeeeeeeeeee       2
2                            2
2           bb          cc   2
2           bb          cc   2
2                            2
2                            2
2                            2
2                            2
2                            2
2                            2
2                            2
2                            2
2                            2
2                            2
2                            2
2                            2
2                            2
2                            2
2                            2
2                            2
22222222            2222222222