TILEMAP
30 60							-- Size of tile map in tiles
16 16 							-- Tile size & block si16
images/bloques.png 	-- Tilesheet
2 2 								-- Number of tiles in tilesheet
2
111111111111111111111111111111
1                            1
1                            1
1                            1
1                            1
1                            1
1                            1
1                            1
1                            1
1                            1
1                            1
1                            1
1                            1
1                            1
1                            1
1                            1
1                            1
1                            1
1                            1
1                            1
1                            1
1                            1
1                            1
1                            1
1                            1
1                            1
1                            1
1                            1
1                            1
11111                     1111
11111ddddddddddddddddddddd1111
1            bbcc            1
1            bbcc            1
1                            1
1       aaaaaaaaaaaaaa       1
1     aaaaaaaaaaaaaaaaaa     1
1   aaaaaaaaaaaaaaaaaaaaaa   1
1   aaaaaaaaaaaaaaaaaaaaaa   1
1     ffffffffffffffffff     1
1       eeeeeeeeeeeeee       1
1       bbbbbbbbbbbbbb       1
1       bbbbbbbbbbbbbb       1
1                            1
1                            1
1                            1
1                          gg1
1                          gg1
1                          hh1
1                          hh1
1                            1
1                            1
1                            1
1                            1
1                            1
1                            1
1                            1
1                            1
1                            1
1                            1
12311111            1111111111