TILEMAP
30 90 							-- Size of tile map in tiles
16 16 							-- Tile size & block size
images/bloques.png 	-- Tilesheet
2 2 
3								-- Number of tiles in tilesheet
111111111111111111111111111111
1                            1
1                            1
1                            1
1                            1
1                            1
1                            1
1                            1
1                            1
1                            1
1                            1
1                            1
1                            1
1                            1
1                            1
1                            1
1                            1
1                            1
1                            1
1                            1
1                            1
1                            1
1                            1
1                            1
1                            1
1                            1
1                            1
1                            1
1                            1
11         11111111         11
11ddddddddd11111111ddddddddd11
1                            1
1                            1
1                            1
1                            1
1                            1
1                            1
1                            1
1                            1
1                            1
1                            1
1                            1
1                            1
1                          cc1
1                          cc1
1                            1
1                            1
1                            1
1                            1
1                            1
1                            1
1                            1
1                            1
1                            1
1                            1
1                            1
1                            1
1                            1
1                            1
11111                     1111
11111ddddddddddddddddddddd1111
1                            1
1                            1
1                            1
1       aaaaaaaaaaaaaa       1
1     ffffffffffffffffff     1
1   aaaaaaaaaaaaaaaaaaaaaa   1
1   aaaaaaaaaaaaaaaaaaaaaa   1
1     ffffffffffffffffff     1
1       eeeeeeeeeeeeee       1
1                            1
1           bb          cc   1
1           bb          cc   1
1                            1
1                            1
1                            1
1                            1
1                            1
1                            1
1                            1
1                            1
1                            1
1                            1
1                            1
1                            1
1                            1
1                            1
1                            1
1                            1
11111111            1111111111

